#domain
hospital
#levelname
PIAF2
#colors
red: 0, A
green: 1, B
blue: 2, C
purple: 3, D
brown: 4, E
lightblue: 5, F
cyan: 6, G
orange: 7, H
pink: 8, I
grey: 9, J
#initial
+++++++++++++++++++++++++
+++++++++++++++   +5  F +
+++++++++++++++ +++++++ +
+++++++++++++++         +
+++++++++++++++++++++++++++
+                 6       +
+  +++++++++++++++   + +  +
+  +++++++++++++++G+  +   +
+  +++++++++++++++  +++ J9+
+  +++++++++ +++++H7  +   +
+  +++++1+4+ +++++++      +
+  +++0AB EC     +   ++++ +
+  +++++ + + +++++      I8+
+  +++++ + + +++++  ++    +
+  +++++ + + +++++    ++ ++
+  3D          +++   +++  +
+  +++++ + + +++++   +++ ++
+  +++++ + +2+++++ +   +  +
+  +++++++++++++++ + + ++ +
+                         +
+++++++++++++++++++++++++++
#goal
+++++++++++++++++++++++++
+++++++++++++++  F+     +
+++++++++++++++ +++++++ +
+++++++++++++++         +
+++++++++++++++++++++++++++
+                         +
+  +++++++++++++++   + +  +
+  +++++++++++++++ +  +   +
+  +++++++++++++++  +++   +
+  +++++++++A+++++    +  I+
+  +++++ + + +++++++      +
+  +++          C+   ++++ +
+  +++++ + + +++++        +
+  +++++ + + +++++  ++    +
+  +++++ + + +++++    ++ ++
+J        G   B+++   +++  +
+  +++++ + + +++++   +++ ++
+  +++++E+ + +++++ + D +  +
+  +++++++++++++++ + + ++ +
+                     H   +
+++++++++++++++++++++++++++
#end
