#domain
hospital
#levelname
PIAF2simple
#colors
red: 0, A
green: 1, B
blue: 2, C
brown: 3, E
#initial
++++++++++++++++
++++++++++ +++++
++++++1+3+ +++++
++++0AB EC     +
++++++ + + +++++
++++++ + + +++++
++++++ + + +++++
+            +++
++++++ + + +++++
++++++ + +2+++++
++++++++++++++++
#goal
++++++++++++++++
++++++++++A+++++
++++++ + + +++++
++++          C+
++++++ + + +++++
++++++ + + +++++
++++++ + + +++++
+           B+++
++++++ + + +++++
++++++E+ + +++++
++++++++++++++++
#end
