#domain
hospital
#levelname
TAmjedC
#colors
red: 0, A
cyan: 1, B
#initial
++++++++++
+++++1++++
+++++B++++
+  0A    +
+++++ ++++
+++++ ++++
++++++++++
#goal
++++++++++
+++++ ++++
+++++ ++++
+       A+
+++++ ++++
+++++B++++
++++++++++
#end
