#domain
hospital
#levelname
TAmjedB
#colors
red: 0, A
cyan: 1, B
#initial
++++++++++
+++++ ++++
+  0A1   +
+++++B++++
+++++ ++++
++++++++++
#goal
++++++++++
+++++ ++++
+       A+
+++++ ++++
+++++B++++
++++++++++
#end
