#domain
hospital
#levelname
TMAExample
#colors
red: 0, A
blue: 1, B
#initial
++++++++++++
+       0+ +
+ ++++++++A+
+          +
+ ++++++++ +
+ +1 B     +
++++++++++++
#goal
++++++++++++
+        +A+
+ ++++++++ +
+          +
+ ++++++++ +
+ +   B    +
++++++++++++
#end
