#domain
hospital
#levelname
TMAsimple10_no_deadlocks
#colors
red: 0, A
green: 1, B
blue: 2, C
#initial
+++++++++++++++
+++++++++ +++++
++++++1++ +++++
++++ 0  A     +
++++++ ++ +++++
++++++B++ +++++
++++++ ++ +++++
+           +++
++++++ ++C+++++
++++++ ++2+++++
+++++++++++++++
#goal
+++++++++++++++
+++++++++C+++++
++++++ ++ +++++
++++         A+
++++++ ++ +++++
++++++ ++ +++++
++++++ ++ +++++
+           +++
++++++ ++ +++++
++++++B++ +++++
+++++++++++++++
#end