#domain
hospital
#levelname
TMAsimple8
#colors
red: 0, A
green: 1, B
blue: 2, C
purple: 3, D
brown: 4, E
#initial
++++++++++++++++
++++++++++ +++++
++++++1+4+ +++++
++++0AB E      +
++++++ + + +++++
++++++ + + +++++
++++++ + + +++++
+3D          +++
++++++ + +C+++++
++++++ + +2+++++
++++++++++++++++
#goal
++++++++++++++++
++++++++++C+++++
++++++ + + +++++
++++          A+
++++++ + + +++++
++++++ + + +++++
++++++ + + +++++
+           D+++
++++++ + + +++++
++++++B+E+ +++++
++++++++++++++++
#end
