#domain
hospital
#levelname
TSAD1S
#colors
blue: 0, A
#initial
+++++++++
+0      +
+    ++++
+       +
+    ++A+
+     + +
+++++++++
#goal
+++++++++
+       +
+    ++++
+       +
+    ++ +
+     +A+
+++++++++
#end
